1111111111111111111
1000001000000000001
1011101011111111101
1010100010000000001
1010111110111110111
1010000000100010001
1011111111101011101
1010000010001000101
1010111010111110101
1000001010100010101
1011111010111010111
101000001000101000s
1010111011101011111
1010001010001000001
1011101010111111101
1000101010100000001
1110101110111011101
1000100000000010001
1111111e11111111111
