11111111111111111111111111111111111s1111111111111111111111111
1000001000001000000000001000101000001000101000000000001000001
1011101011111011111011101010101011111010101010111111101011101
1000100010001000101000100010101010000010101010100000101010001
1010111110101110101110111110101010101110101010101011101010101
e010001000100000101000100010001010101000100010101010001010101
1011101011111111101011101011101011101011111010101010111110101
1000100010000000001000101000101000001000001010101010100000101
1110111110111110111110111010101111111111101010111010101111101
1010100010100010100000100010100010001000101010001000101000101
1010101010101110101111101111111010101010101111101011101011101
1010001000100000100000100000001000101010101000001000101000101
1011111111101111111110101110101111101010101011111110101110101
1000001000101000001000101010101000100010101000100010001000101
1011101110101011101011101010111010111110101110101011111011101
1000101000101000101000100010000010000010100010001000100000101
1010101011101111101110111111101111101110111010111110101110101
1010100010001000101000100000100000101000001010000010101010001
1010111110111010101011101110111110101011111011111110101011111
1010100000100010101010001010100000100010000010000000100010001
1110101111101110101010111010111110111110111110111111111010101
1000101000001010101010100010100010001000100000100000001000101
1011101110111010101010101010101011111011111011101111101111101
1000101000100000001010001010001000001000000010001000100000101
1110101011111111111011111011111111101111111110111011101111101
1000101000100000001000001010000010100000001010001000001000001
1010101010101111101111101010111010101111101010101111111011111
1010101010100010000000001010001000100010001010100000000010001
1011101110111011111111111010101110111011101010111111111110101
1000101000001010000000100010100010001000100010100000100010101
1110101011101010111110101110111011101110111010101111101010101
1000100010101010001010100010001010000010100010100000001000101
1011111110101011101010111011111011111110111110111111111111101
1000100000001000001010001010000010000000100010000000001000001
1010101111111111111011101010111010111111101011111111101011101
1010000000000000000000100000100010000000001000000000000010001
1111111111111111111111111111111111111111111111111111111111111
