111111111111111111111111111111111111111111111111111111111
100000001000101000000000000010001000101000001010000010001
111011101010101011111011111010101010101010101010111010101
100010000010100010000010000000100010100010100010101000101
101110111110111110101111111111111110101110111110101111101
101000100010000000101000000010000010100010100000100000101
101111101011111011111011111010101110111110101111111110101
100010001000100010001000100010100000100000100000000000101
101010111110111110101110101110111111101110111111111110101
101000000010000000101000101000001000000010001000000010101
101111111111111011101011101111101110111011111011101110101
101010000000001010001000100000100010001000100010100000101
101010111111101110111110111110111011101110101110111111101
101010000010100010100000100000100010000010000000001000101
101011111010111010101111101111101110111111111110111010101
100010100010000000100010001000101000100000100010100010101
111010101111101111111010111110101011101110101010101110101
s01010100000101000000010100000101010001010101000101000101
101010111110111011111110101011101110111010111110101011101
100010100010001010000010101000100010100000100010101000001
101110101011101010111010101110111010111011101010101111101
100010001000100010001000101010000010001000101010100010101
111011111110111111101111101011111111101110101011111010101
100000000000000000100010000000000000001000001000000010001
111111111111111111111e11111111111111111111111111111111111
