11111111111111111111111111111111111
1000100000000000000010000010000000s
10111011111111111110101011101111111
10100010000000001000101000001000101
10101111111010111010101111111010101
10100000000010100010101000000010001
10111111111110101110101010111111101
10000000000000101000101010001000101
10111111111111101111101011101011101
10100010000000001000001000101010001
10101110111111111011111111101010111
10100010100010000010000000001000101
10111010101010111111101111111011101
10100010001010001000001000001010001
10101111111011101011111010111011101
10100000001000101010100010001000101
10111110101110101010101111101110101
10000010100010101010001000100010101
11111010111010101010111010111010101
10001010001010100010100010101010101
10111011101010111110111010101010101
10000000001010000000000010001000001
111111111111111111111111111e1111111
