111111111
100000001
101011111
101010001
101010101
s0100010e
101111111
100000001
111111111
